1111111111111
1C0100C000001
100P011111001
1C0011E00C0C1
1111111111111
